000000#0000000000000
0AAAAAAAFAAA0BAAAFA0
0AAAAAAAFAAFBBBFDEE0
000000#0000000000010
00000000000000000000
00000000000000000000
00000000000000000000
00000000000000000000
00000000000000000000
00000000000000000000
00000000000000000000
00000000000000000000
;test.txt,6,2.5
#default.txt,15,1
;test_dead_hunter,1,1
;ENTITIES