000000#0000000000000
0AAAAAAAFAAA0BAAAFA0
0AAAAAAAFAAFBBBFDEE0
000000#000B0000A0010
0000000000B0000B0000
0000000000A0000B0000
0000543210BACCFD0000
00000000000000000000
00000000000000000000
00000000000000000000
00000000000000000000
00000000000000000000
;test.txt,6,2.5
#default.txt,15,1
;test_dead_hunter,1,1
;Entity?